F		129,	110, 30
C 236,			212,  153

NO			   ./assets/backrooms.xpm
SO					./assets/backrooms.xpm
WE	./assets/backrooms.xpm
EA			./assets/backrooms.xpm
1111111111111111111111111111111
1000100000010000010100001010001
1010101101010101000101101000E01
1011100101000001010100101010001
1000000101011101010111100011011
1011110111000101010000001010001
1000010000010101111111011011101
1111010111010100001000000010001
1000011101011111111101111111111
1101110100010000100101000010001
1000010001111011110101001010101
1110110111010010010111101011101
1010000000010111000100101110001
1000100101010101110101101000101
1111110101000000010100000010101
1000000111111111000111011111101
1011110010101001010100000010101
1010000010001011110110111000101
1011111110111010000100100010001
1000000000101010110110101011101
1101010111100000100100101000101
1001010000111011110101101110111
1011011111101010010001001000001
1010000000000000111100011011101
1011111101010111010111110010101
1010001001110000010010011110001
1000101011000111011010000000101
1111101000011101001010111011111
1000111111110101000000101000001
1000001000100000011110101110101
1011110111000101010000001010001
1000010000010101111111011011101
1111010111010100001000000010001
1000011101011111111101111111111
1101110100010000100101000010001
1000010001111011110101001010101
1110110111010010010111101011101
1010000000010111000100101110001
1000100101010101110101101000101
1111110101000000010100000010101
1000000111111111000111011111101
1011110010101001010100000010101
1010000010001011110110111000101
1011111110111010000100100010001
1000000000101010110110101011101
1101010111100000100100101000101
1001010000111011110101101110111
1011011111101010010001001000001
1010000000000000111100011011101
1011111101010111010111110010101
1010001001110000010010011110001
1000101011000111011010000000101
1111101000011101001010111011111
1000111111110101000000101000001
1000001000100000011110101110101
1000100010001001010000100000101
1111111111111111111111111111111
