NO ./assets/north.xpm
SO ./assets/south.xpm
WE ./assets/west.xpm
EA ./assets/east.xpm

F 64,64,64
C 128,128,128

11111111111111     1111111
10000000000001     1000001
10111110000001     1000001
101   10000001     1000001
10111110000001111111000001
10000000000000000000000001
10000000000000000000000001
10000000000000000000000001
100000000N0000000000000001
10111000000000000001111101
101 1000000000000001   101
10111000000000000001   101
10000000000000000001   101
10000011111111000001   101
1000001      1000001   101
1000001      1000001   101
1000001      1111111   101
1000001                101
10000011111111111111111101
10000000000000000000000001
11111111111111111111111111
