F	80,80,80
C	120,120,120

NO	./assets/red.xpm
SO	./assets/green.xpm
WE	./assets/blue.xpm
EA	./assets/yellow.xpm

11111111111111111
10000000000000001
10101010101010101
10000000000000001
10101010101010101
10000000000000001
10101010101010101
10000000000000001
10101010101010101
10000000N00000001
10101010101010101
10000000000000001
10101010101010101
10000000000000001
10101010101010101
10000000000000001
10101010101010101
10000000000000001
11111111111111111
