NO ./assets/crafting.xpm
SO ./assets/cobblestone.xpm
WE ./assets/oak-planks.xpm
EA ./assets/grass.xpm

F 64,64,64
C 128,128,128

1111111111
1000000001
1000000001         11111111
1000000001         10000001
1000000001  11111  10000001
111100000111100011110000001
   100000000000000000000011
   10000000000000000000001
   10000011110000000000001
   10000010000000000000001
   10000010N000001110000011111
   100000100000001110000000001
   100000000000001110000000001
   100000000000000000000000001
   100000000000000000000000001
   100000011111111111111111111
   10000001
   11111111
