NO	./assets/red.xpm
SO	./assets/green.xpm
F	80,80,80
C	120,120,120
WE	./assets/blue.xpm
EA	./assets/yellow.xpm

1111111111111111111111111111111
1000101000010100000100000010001
10N0001011010001010101011010101
1000101010010101000001010011101
1101100011110101011101010000001
1000101000000101010001110111101
1011101101111111010100000100001
1000100000001000010101110101111
1111111111011111111101011100001
1000100001010010000100010111011
1010101001010111101111000100001
1011101011110100100101110110111
1000111010010001110100000000101
1010001011010111010101010010001
1010100000010100000001010111111
1011111101110001111111110000001
1010100000010101001010100111101
1010001110110111101000100000101
1000100010010000101110111111101
1011101010110110101010000000001
1010001010010010000011110101011
1110111011010111101110000101001
1000001001000100101011111101101
1011101100011110000000000000101
1010100111110101110101011111101
1000111100100100000111001000101
1010000000101101110001101010001
1111101110101001011100001011111
1000001010000001010111111110001
1010111010111100000010001000001
1010000010000101001000100010001
1111111111111111111111111111111
