NO ./assets/blue_stone.xpm
SO ./assets/blue_stone.xpm
WE ./assets/blue_stone.xpm
EA ./assets/blue_stone.xpm

C 56,60,61
F 116,115,114

     11111
     10001
     10001
     10001
     10001
     10001
     10001
     10001
     10001
     10001
     10001
     10001
111111000111111
100001000100001
100000000000001
100001000100001
100001000100001
111111000111111
100001000100001
10E000000000001
100001000100001
111111000111111
100000000000001
100000000000001
100000000000001
111111111111111
